+--+--+--+--+--+--+--+--+--+--+--+--+--+--+--+--+--+--+--+--+
   |     |              |        |        |        |        |
+  +  +  +  +--+--+--+  +  +--+  +--+--+  +  +--+  +--+--+  +
|     |  |  |        |  |  |  |        |  |  |              |
+--+--+  +  +  +--+  +  +  +  +--+--+  +  +  +--+  +--+--+--+
|     |  |  |     |  |     |           |  |     |  |        |
+  +  +  +  +  +  +  +--+  +--+--+--+--+  +--+  +  +  +--+  +
|  |  |     |  |  |        |           |     |  |     |  |  |
+  +  +--+--+  +  +--+--+--+--+--+  +  +--+  +  +  +--+  +  +
|  |           |  |     |     |     |        |  |  |     |  |
+  +--+--+--+--+  +--+  +  +  +  +--+--+--+--+  +  +  +  +--+
|              |        |  |  |  |     |     |  |  |  |     |
+--+  +--+--+  +--+--+--+  +  +  +  +  +  +  +  +  +--+--+  +
|  |  |     |           |  |     |  |     |     |           |
+  +  +  +  +--+--+--+  +  +--+--+  +--+--+--+--+--+  +--+--+
|     |  |     |        |  |        |     |           |     |
+--+--+--+  +  +  +--+--+  +  +  +--+--+  +--+--+--+--+  +--+
|  |        |     |     |  |  |     |     |     |     |     |
+  +  +--+--+  +--+  +  +  +  +--+  +  +--+  +  +  +  +--+  +
|     |     |     |  |     |  |     |  |     |     |        |
+  +--+  +  +--+  +  +--+--+  +--+--+  +  +--+--+--+  +--+  +
|     |  |  |  |     |     |        |  |           |     |  |
+--+  +  +  +  +--+--+--+  +--+--+  +  +--+  +--+--+--+  +  +
|  |  |  |     |           |     |  |     |  |     |  |  |  |
+  +  +  +--+--+  +--+--+  +  +  +  +--+  +--+  +  +  +  +  +
|        |     |     |     |  |     |  |        |        |  |
+--+  +--+  +  +--+  +  +--+  +  +--+  +--+--+--+--+  +--+--+
|     |     |        |        |        |           |  |     |
+  +--+  +--+--+--+--+--+  +--+--+--+--+  +--+--+  +  +  +  +
|     |     |           |  |        |     |        |     |  |
+--+  +--+  +  +--+--+  +  +--+--+  +  +--+  +--+--+--+  +  +
|     |  |  |  |     |     |     |     |  |     |        |  |
+  +--+  +  +  +  +  +--+--+  +  +  +--+  +--+--+  +  +--+  +
|           |     |  |     |  |                 |  |     |  |
+--+--+  +--+  +  +  +  +  +  +--+  +--+--+--+  +  +--+--+  +
|        |     |  |     |     |  |  |     |     |  |     |  |
+  +--+--+--+--+--+--+  +--+--+  +  +  +--+  +--+--+  +  +  +
|     |           |     |     |     |  |     |     |  |     |
+--+  +  +--+--+  +  +--+  +  +--+--+  +  +--+  +  +  +  +--+
|        |        |        |           |        |     |
+--+--+--+--+--+--+--+--+--+--+--+--+--+--+--+--+--+--+--+--+
