+--+--+--+--+--+--+--+--+--+--+--+--+--+--+--+--+--+--+--+--+
      |        |     |     |     |           |              |
+--+  +  +--+  +--+  +  +  +--+  +  +--+--+  +  +  +--+--+  +
|     |  |           |  |  |     |  |     |  |  |     |     |
+  +--+--+  +  +--+--+  +  +  +--+  +--+  +  +  +--+--+  +--+
|        |  |     |     |     |  |        |  |  |        |  |
+--+--+  +--+--+  +  +--+  +--+  +  +--+--+  +  +  +--+--+  +
|     |           |     |     |  |        |  |  |  |     |  |
+  +  +--+  +--+--+--+  +--+--+  +--+--+--+  +  +  +  +  +  +
|  |        |     |  |     |     |        |     |     |     |
+  +--+--+--+  +  +  +--+  +  +--+  +--+  +  +--+--+  +--+--+
|  |        |  |        |  |     |  |  |  |        |        |
+  +  +--+  +  +--+  +--+  +--+  +  +  +  +  +--+  +  +--+--+
|  |  |  |  |  |        |           |  |     |  |  |  |     |
+  +  +  +  +  +--+--+  +--+--+  +--+  +--+--+  +  +  +  +  +
|  |     |           |     |  |     |              |  |  |  |
+  +--+--+--+  +--+  +--+  +  +--+  +--+--+--+--+--+  +--+  +
|     |     |  |        |           |                 |     |
+--+  +  +  +  +  +--+--+--+--+--+--+  +--+--+--+  +--+  +--+
|     |  |  |  |  |        |        |           |        |  |
+  +--+  +  +  +  +--+--+  +--+--+  +--+--+  +--+--+--+--+  +
|  |     |     |     |     |     |     |     |     |     |  |
+  +  +--+--+--+--+  +  +--+  +  +--+  +--+--+  +  +  +  +  +
|  |     |        |        |  |     |  |     |  |     |  |  |
+  +--+  +  +--+--+--+  +  +  +  +  +  +  +  +  +--+  +  +  +
|        |           |  |     |  |  |  |  |  |  |     |     |
+--+--+--+  +--+--+  +  +--+--+  +  +  +  +  +  +  +--+--+--+
|  |     |  |     |     |        |        |     |     |     |
+  +  +  +  +  +--+--+--+  +--+--+--+  +--+--+--+--+  +  +  +
|     |  |  |  |        |  |              |           |  |  |
+--+--+  +  +  +  +--+--+  +  +--+--+  +  +  +--+  +--+  +  +
|     |  |     |           |  |        |  |     |  |     |  |
+  +  +  +--+--+--+--+--+--+  +  +--+--+--+--+  +  +  +--+  +
|  |  |        |           |  |  |     |        |  |  |     |
+  +  +--+--+  +  +--+--+  +  +  +  +--+  +--+--+  +  +  +--+
|  |     |     |  |     |     |  |        |     |     |  |  |
+  +--+  +  +--+  +  +  +--+--+--+  +--+--+  +--+--+  +  +  +
|     |  |        |  |              |     |     |     |     |
+  +  +--+--+--+--+  +  +--+--+--+--+--+  +--+  +  +--+--+--+
|  |                 |                          |
+--+--+--+--+--+--+--+--+--+--+--+--+--+--+--+--+--+--+--+--+
