+--+--+--+--+--+--+--+--+--+--+--+--+--+--+--+--+--+--+--+--+
               |              |           |     |        |  |
+--+--+--+--+  +--+  +--+  +  +  +--+--+  +  +--+  +--+  +  +
|     |  |        |     |  |  |        |  |           |     |
+  +  +  +  +  +  +--+  +  +  +--+--+  +  +--+--+  +  +--+--+
|  |  |     |  |  |  |  |  |  |     |  |        |  |        |
+  +  +--+--+--+  +  +  +  +--+  +--+  +--+--+  +  +--+--+  +
|  |                 |  |     |        |           |        |
+  +--+--+--+--+--+--+  +--+  +--+--+--+  +--+  +  +  +--+--+
|           |        |  |  |  |     |        |  |  |     |  |
+--+  +--+  +  +--+  +  +  +  +  +  +--+--+  +  +--+--+  +  +
|     |  |  |     |  |  |        |  |        |     |     |  |
+  +--+  +  +  +  +  +  +  +--+--+--+  +--+--+--+  +  +--+  +
|     |  |     |  |     |        |              |  |     |  |
+--+  +  +--+--+--+--+--+--+--+  +  +--+--+--+--+  +  +  +  +
|     |  |              |        |  |     |     |  |  |  |  |
+  +--+  +--+  +--+  +  +  +--+--+--+  +  +  +  +  +  +  +  +
|  |     |     |  |  |     |  |     |  |  |  |  |  |  |     |
+  +--+  +  +--+  +  +  +--+  +  +  +  +--+  +  +  +--+--+--+
|        |  |        |     |     |  |        |  |     |     |
+--+--+--+  +  +--+--+--+--+--+--+  +--+--+--+  +--+  +  +  +
|     |     |     |        |     |  |  |     |     |  |  |  |
+  +--+  +  +--+  +  +--+  +  +  +  +  +  +  +  +  +  +  +  +
|        |  |     |  |     |  |  |  |     |     |  |  |  |  |
+--+--+--+  +  +--+--+  +--+--+  +  +  +--+--+--+  +  +--+  +
|        |  |           |     |  |  |     |     |     |     |
+  +--+--+  +--+--+--+--+  +  +  +  +--+  +--+  +--+--+  +--+
|     |     |           |  |  |  |              |           |
+  +  +  +--+  +--+--+  +  +  +  +--+  +  +--+--+--+--+--+  +
|  |     |     |        |  |  |        |                 |  |
+  +--+--+  +--+  +--+--+  +  +--+--+--+  +--+--+--+--+  +  +
|        |  |     |     |  |  |        |  |     |     |     |
+--+--+  +  +  +--+  +  +  +  +  +--+  +  +  +  +  +  +--+  +
|     |     |        |  |  |     |     |  |  |     |  |     |
+  +  +--+  +--+--+--+  +  +--+  +  +--+  +  +--+--+  +  +--+
|  |        |        |  |  |     |        |  |        |     |
+  +--+--+--+  +--+  +  +  +--+--+--+  +  +  +  +--+--+--+  +
|  |     |  |  |        |  |        |  |     |  |        |  |
+  +--+  +  +  +--+--+--+  +  +--+--+  +--+--+  +  +--+  +  +
|           |              |                 |     |     |
+--+--+--+--+--+--+--+--+--+--+--+--+--+--+--+--+--+--+--+--+
