+--+--+--+--+--+--+--+--+--+--+--+--+--+--+--+--+--+--+--+--+
      |        |        |     |        |           |        |
+  +--+  +--+  +  +--+  +  +--+  +--+  +  +--+--+  +  +--+  +
|        |     |  |     |        |  |           |  |  |  |  |
+--+--+--+  +--+  +--+  +--+--+--+  +--+  +--+--+  +  +  +  +
|           |     |     |           |  |  |     |  |  |     |
+  +--+--+--+  +--+  +--+  +--+  +--+  +  +  +  +  +  +--+--+
|     |        |     |     |     |        |  |     |  |     |
+--+  +  +--+--+  +--+  +--+  +--+  +--+--+  +--+--+  +  +  +
|  |  |  |        |  |     |        |     |        |  |  |  |
+  +  +  +  +--+--+  +--+  +--+  +--+  +  +--+--+  +  +  +  +
|  |     |  |        |        |     |  |        |  |  |  |  |
+  +--+--+  +  +--+  +  +--+  +--+  +  +--+  +--+  +  +--+  +
|        |     |     |  |  |  |     |     |     |     |     |
+--+--+  +--+--+  +--+  +  +  +  +--+--+  +--+  +--+--+  +--+
|        |           |  |  |  |           |  |  |     |  |  |
+--+--+  +  +  +--+--+  +  +  +--+--+--+--+  +  +  +  +  +  +
|        |  |  |     |  |  |  |           |  |  |  |        |
+  +--+--+  +  +  +  +  +  +  +  +--+--+  +  +  +  +--+--+  +
|  |        |     |  |  |     |  |     |  |     |  |     |  |
+  +  +--+--+--+--+  +  +--+--+  +  +  +  +--+  +  +--+  +--+
|     |        |     |        |     |  |        |     |     |
+  +  +--+--+  +--+--+--+  +--+--+--+  +--+--+--+--+  +--+  +
|  |  |     |                 |        |     |        |     |
+  +--+  +  +--+--+--+--+--+  +  +  +--+  +  +  +--+--+  +--+
|  |     |     |     |        |  |  |     |  |  |  |     |  |
+  +  +  +--+  +  +  +--+  +--+--+  +  +--+--+  +  +  +--+  +
|  |  |  |  |  |  |        |  |     |  |     |        |     |
+  +--+  +  +  +  +--+--+--+  +  +--+  +  +  +  +--+--+  +--+
|           |  |  |           |           |     |        |  |
+--+--+  +--+  +  +  +--+  +--+--+--+--+--+--+--+  +--+--+  +
|        |  |  |     |     |              |        |        |
+  +--+--+  +  +  +--+  +--+  +--+--+--+  +  +  +--+  +--+--+
|  |     |  |     |  |     |           |     |        |     |
+  +  +  +  +  +--+  +--+  +  +--+--+  +--+--+  +  +--+  +  +
|     |  |  |     |  |  |  |        |  |  |     |  |     |  |
+--+  +--+  +--+  +  +  +  +--+--+--+  +  +  +--+  +  +--+  +
|     |     |     |  |  |              |     |     |  |  |  |
+  +--+  +--+  +--+  +  +--+--+--+--+--+--+--+  +--+  +  +  +
|        |           |                                |
+--+--+--+--+--+--+--+--+--+--+--+--+--+--+--+--+--+--+--+--+
