+--+--+--+--+--+--+--+--+--+--+--+--+--+--+--+--+--+--+--+--+
      |                 |              |     |        |     |
+--+  +  +  +--+--+  +  +--+  +--+--+  +--+  +  +--+  +  +  +
|     |  |     |     |     |  |     |     |  |     |  |  |  |
+  +--+--+--+  +--+--+--+  +  +  +  +--+  +  +--+  +  +  +--+
|  |        |  |     |     |  |  |  |     |        |  |     |
+  +  +--+  +  +  +  +  +--+  +  +--+  +--+--+--+  +--+--+  +
|     |  |  |  |  |     |     |     |                       |
+--+--+  +  +--+  +--+--+  +--+--+  +--+--+--+--+  +--+--+--+
|     |           |     |  |     |     |        |     |     |
+  +--+--+  +--+--+--+  +  +  +  +--+  +  +--+  +--+  +  +  +
|     |  |  |           |  |  |        |  |  |        |  |  |
+--+  +  +  +  +--+--+--+  +--+  +--+--+  +  +  +--+--+  +--+
|              |        |     |     |     |     |     |     |
+--+--+--+  +--+--+--+  +--+  +  +  +--+  +--+--+  +--+--+  +
|        |           |  |  |  |  |     |  |     |           |
+  +--+  +  +--+  +--+  +  +  +  +--+  +  +  +  +  +--+--+  +
|  |     |     |  |           |     |  |  |  |     |        |
+  +--+--+--+  +  +  +  +--+--+--+  +  +  +  +--+--+  +--+--+
|  |           |     |  |        |  |     |     |     |     |
+  +  +--+--+--+--+--+  +  +--+  +  +--+  +--+  +  +--+  +--+
|  |  |           |     |     |  |     |        |     |     |
+  +  +  +--+--+  +  +--+--+  +  +--+  +  +--+--+--+  +  +  +
|     |     |  |     |        |        |     |        |  |  |
+--+--+--+  +  +--+--+  +--+--+--+--+--+--+--+  +--+--+  +  +
|        |  |  |     |  |        |     |              |  |  |
+  +--+  +  +  +  +  +  +--+--+  +  +  +  +--+  +--+  +  +  +
|     |     |     |  |        |  |  |     |        |     |  |
+--+  +--+--+--+--+  +--+--+  +  +--+--+--+--+--+--+  +--+  +
|     |     |        |     |  |     |              |  |     |
+  +--+--+  +  +--+--+  +--+  +--+  +  +  +--+--+  +--+  +--+
|  |     |  |     |     |     |     |  |  |     |           |
+  +  +  +  +--+  +  +--+  +--+--+  +  +  +--+  +--+  +--+  +
|     |        |  |     |     |     |  |     |     |     |  |
+--+--+--+  +--+  +  +  +  +  +  +--+--+--+  +  +--+--+  +--+
|        |     |  |  |     |  |  |           |        |     |
+  +  +--+--+  +  +--+--+--+--+  +  +  +--+--+--+--+  +--+  +
|  |        |  |     |     |     |  |     |        |     |  |
+  +--+--+  +  +--+  +  +  +  +--+  +--+  +--+--+  +--+  +  +
|        |              |     |        |              |
+--+--+--+--+--+--+--+--+--+--+--+--+--+--+--+--+--+--+--+--+
